asc	text/plain
asf	video/x-ms-asf
asx	video/x-ms-asf
avi	video/x-msvideo
bmp	image/bmp
bz2	application/x-bzip
cc	text/plain
class	application/octet-stream
conf	text/plain
cpp	text/plain
css	text/css
c	text/plain
diff	text/plain
dmg	application/x-apple-diskimage
dtd	text/xml
dvi	application/x-dvi
ebuild	text/plain
eclass	text/plain
gif	image/gif
gz	application/x-gzip
hh	text/plain
hpp	text/plain
h	text/plain
html	text/html
htm	text/html
ico	image/x-icon
jpeg	image/jpeg
jpg	image/jpeg
js	text/javascript
log	text/plain
m3u	audio/x-mpegurl
mov	video/quicktime
mp3	audio/mpeg
mpeg	video/mpeg
mpg	video/mpeg
ogg	application/ogg
pac	application/x-ns-proxy-autoconfig
patch	text/plain
pdf	application/pdf
png	image/png
ps	application/postscript
qt	video/quicktime
rtf	application/rtf
sig	application/pgp-signature
spl	application/futuresplash
svg	image/svg+xml
svgz	image/svg+xml
swf	application/x-shockwave-flash
tar	application/x-tar
tar.bz2	application/x-bzip-compressed-tar
tar.gz	application/x-tgz
tar.xz	application/x-xz-compressed-tar
tbz	application/x-bzip-compressed-tar
text	text/plain
tgz	application/x-tgz
tiff	image/tiff
tif	image/tiff
torrent	application/x-bittorrent
txt	text/plain
wav	audio/x-wav
wax	audio/x-ms-wax
wma	audio/x-ms-wma
wmv	video/x-ms-wmv
xbm	image/x-xbitmap
xml	text/xml
xpm	image/x-xpixmap
xwd	image/x-xwindowdump
xz	application/x-xz
zip	application/zip
